W W W W W W W W W W W W W
W - - - - - C - - - - - W
W - E - - C H C - - K - W
W - D - - - C - - - - - W
- - - - - C - - S - - - -
- H - - H - - - - - - - -
- - - - H - - - - - - - -
- C C - H - - - - - - - -
W C C - - C - - - D - - W
W C C - - C - - - - - - W
W P C - - C - - - - - - W
W W W W W W W W W W W W W