W W W W W W W W W W W W W
W R W G R W R W D R R D W
W D R D G W G W R G D G W
W P D D D W D W D D W W W
W D D D D W D W D D D D W
W D D D D W D W D D D D W
W R D D W W D W W D D D W
W G D D W G D D W D R D W
W W D D D D D D D D D E W
W W W W W W W W W W W W W