W W W W W W W W W W W W W 
W G D D W D D R R W G D W
W W D R W G D D D W W D W
W P D D D D D D D W D D W
W W D D D W W W D W R D W
W D D D W W R D D D D D W
W D D W W G R D D D D R W
W D D W W D D D D D D D W
W D D D D D D D D D D G W
W W D D D D D D D W W W W
W W D D G D D D D D D E W
W W W W W W W W W W W W W