W W W W W W W W W W W W W
W W D W R G D D R W R G W
W D D D D D D D R G R D W
W P D D D D W W W D D D W
W W W W D D W G D D D D W
W G W R W W W W W D D D W
W D D R D D R R D D D D W
W D D D D D D D D W W W W
W E D D D D D D D D D G W
W W W W W W W W W W W W W