W W W W W W W W W W W W W
W W W W R G W D R W D D W
W W W D D D R D D W G D W
W P D D D D R D D W W D W
W W D W D D D D D D D D W
W G D W W W G D W W R D W
W D R D G W R R W G D D W
W D D D D W D D W W R D W
W D D D D D D D D D - E W
W W W W W W W W W W W W W