W W W W W W W W W W W W W
W G W R R W G W R D R G W
W D D G G W D D D D R D W
W P D D D D D D D G D D W
W D R D D D D D D D D D W
W W D D D D R D D W G D W
W R D D D D G D W W W D W
W D R D D D W D W D D D W
W D G D W W W D G D D E W
W W W W W W W W W W W W W